"team","quarter","year","n_plays","n_pass","n_rush","yards_pass","yards_rush"
"ARI",1,2014,270,154,116,1083,403
"ARI",1,2015,245,142,103,1303,374
"ARI",1,2016,259,144,115,897,478
"ARI",1,2017,245,138,107,989,359
"ARI",1,2018,200,105,95,884,357
"ARI",1,2019,208,119,89,732,581
"ARI",1,2020,232,144,88,845,389
"ARI",1,2021,199,118,81,954,411
"ARI",1,2022,174,100,74,633,370
"ARI",1,2023,183,104,79,544,392
"ARI",2,2014,256,177,79,1315,264
"ARI",2,2015,279,186,93,1444,458
"ARI",2,2016,300,213,87,1466,400
"ARI",2,2017,271,175,96,1330,374
"ARI",2,2018,198,124,74,641,218
"ARI",2,2019,238,147,91,1035,396
"ARI",2,2020,268,163,105,1491,376
"ARI",2,2021,245,151,94,1224,380
"ARI",2,2022,255,173,82,1016,264
"ARI",2,2023,208,111,97,642,432
"ARI",3,2014,215,128,87,944,291
"ARI",3,2015,225,126,99,1197,510
"ARI",3,2016,202,112,90,877,347
"ARI",3,2017,212,125,87,877,314
"ARI",3,2018,180,103,77,507,266
"ARI",3,2019,190,125,65,924,278
"ARI",3,2020,254,148,106,1102,474
"ARI",3,2021,208,129,79,1257,355
"ARI",3,2022,202,124,78,882,384
"ARI",3,2023,155,76,79,527,300
"ARI",4,2014,250,155,95,1119,289
"ARI",4,2015,274,147,127,1163,606
"ARI",4,2016,299,212,87,1410,427
"ARI",4,2017,286,195,91,1203,356
"ARI",4,2018,278,187,91,1269,401
"ARI",4,2019,225,132,93,941,560
"ARI",4,2020,257,142,115,1029,552
"ARI",4,2021,262,136,126,971,545
"ARI",4,2022,248,170,78,984,347
"ARI",4,2023,205,151,54,1050,234
"ARI",5,2014,0,0,0,0,0
"ARI",5,2015,0,0,0,0,0
"ARI",5,2016,16,10,6,124,17
"ARI",5,2017,11,8,3,77,9
"ARI",5,2018,0,0,0,0,0
"ARI",5,2019,14,10,4,84,13
"ARI",5,2020,9,4,5,23,45
"ARI",5,2021,0,0,0,0,0
"ARI",5,2022,8,6,2,36,7
"ARI",5,2023,0,0,0,0,0
"ATL",1,2014,218,123,95,918,389
"ATL",1,2015,239,146,93,1129,361
"ATL",1,2016,231,140,91,1275,453
"ATL",1,2017,255,150,105,1123,381
"ATL",1,2018,226,137,89,1139,430
"ATL",1,2019,242,141,101,955,414
"ATL",1,2020,229,132,97,1077,375
"ATL",1,2021,219,125,94,755,428
"ATL",1,2022,182,92,90,625,396
"ATL",1,2023,151,84,67,511,277
"ATL",2,2014,285,210,75,1703,276
"ATL",2,2015,299,195,104,1393,416
"ATL",2,2016,267,170,97,1408,418
"ATL",2,2017,253,154,99,1292,513
"ATL",2,2018,252,177,75,1480,301
"ATL",2,2019,244,179,65,1332,233
"ATL",2,2020,315,217,98,1496,302
"ATL",2,2021,233,150,83,970,316
"ATL",2,2022,165,87,78,750,386
"ATL",2,2023,223,129,94,876,348
"ATL",3,2014,235,139,96,1531,419
"ATL",3,2015,265,148,117,1106,517
"ATL",3,2016,254,146,108,1581,533
"ATL",3,2017,200,107,93,846,445
"ATL",3,2018,228,139,89,987,459
"ATL",3,2019,219,139,80,1158,300
"ATL",3,2020,221,129,92,850,375
"ATL",3,2021,205,128,77,1013,292
"ATL",3,2022,166,59,107,352,652
"ATL",3,2023,196,99,97,657,474
"ATL",4,2014,270,187,83,1289,290
"ATL",4,2015,261,170,91,1313,296
"ATL",4,2016,204,104,100,892,493
"ATL",4,2017,253,142,111,1210,482
"ATL",4,2018,266,190,76,1626,355
"ATL",4,2019,269,207,62,1590,243
"ATL",4,2020,279,180,99,1271,417
"ATL",4,2021,221,140,81,1064,208
"ATL",4,2022,177,70,107,645,498
"ATL",4,2023,235,115,120,1069,488
"ATL",5,2014,3,1,2,0,4
"ATL",5,2015,4,4,0,24,0
"ATL",5,2016,7,4,3,22,-3
"ATL",5,2017,0,0,0,0,0
"ATL",5,2018,0,0,0,0,0
"ATL",5,2019,0,0,0,0,0
"ATL",5,2020,0,0,0,0,0
"ATL",5,2021,0,0,0,0,0
"ATL",5,2022,12,5,7,80,42
"ATL",5,2023,0,0,0,0,0
"BAL",1,2014,199,107,92,719,368
"BAL",1,2015,223,132,91,974,381
"BAL",1,2016,260,159,101,1243,497
"BAL",1,2017,221,124,97,746,346
"BAL",1,2018,221,115,106,759,569
"BAL",1,2019,200,99,101,871,649
"BAL",1,2020,228,98,130,784,671
"BAL",1,2021,202,107,95,706,440
"BAL",1,2022,182,98,84,614,310
"BAL",1,2023,188,107,81,936,354
"BAL",2,2014,277,173,104,1249,527
"BAL",2,2015,267,180,87,1310,303
"BAL",2,2016,303,234,69,1405,328
"BAL",2,2017,271,176,95,1253,441
"BAL",2,2018,290,185,105,1310,390
"BAL",2,2019,191,108,83,773,566
"BAL",2,2020,262,144,118,911,723
"BAL",2,2021,244,148,96,1142,388
"BAL",2,2022,201,126,75,891,421
"BAL",2,2023,212,132,80,1104,439
"BAL",3,2014,249,152,97,1057,342
"BAL",3,2015,264,175,89,1261,337
"BAL",3,2016,224,137,87,901,365
"BAL",3,2017,243,132,111,847,518
"BAL",3,2018,273,135,138,875,711
"BAL",3,2019,208,116,92,906,516
"BAL",3,2020,209,92,117,680,732
"BAL",3,2021,211,125,86,958,328
"BAL",3,2022,171,83,88,522,590
"BAL",3,2023,158,85,73,601,472
"BAL",4,2014,291,158,133,1293,767
"BAL",4,2015,315,211,104,1408,434
"BAL",4,2016,276,181,95,1209,371
"BAL",4,2017,290,155,135,834,555
"BAL",4,2018,238,120,118,723,524
"BAL",4,2019,251,115,136,875,616
"BAL",4,2020,214,88,126,680,620
"BAL",4,2021,263,172,91,1190,378
"BAL",4,2022,202,85,117,598,589
"BAL",4,2023,190,79,111,557,453
"BAL",5,2014,0,0,0,0,0
"BAL",5,2015,13,5,8,11,24
"BAL",5,2016,0,0,0,0,0
"BAL",5,2017,3,1,2,0,8
"BAL",5,2018,21,12,9,42,45
"BAL",5,2019,5,1,4,1,5
"BAL",5,2020,2,1,1,9,2
"BAL",5,2021,31,16,15,131,80
"BAL",5,2022,0,0,0,0,0
"BAL",5,2023,10,7,3,7,8
"BUF",1,2014,235,138,97,855,323
"BUF",1,2015,228,116,112,850,609
"BUF",1,2016,191,101,90,702,559
"BUF",1,2017,211,113,98,830,442
"BUF",1,2018,219,114,105,753,349
"BUF",1,2019,203,119,84,733,317
"BUF",1,2020,245,161,84,1102,353
"BUF",1,2021,198,123,75,766,375
"BUF",1,2022,184,114,70,866,298
"BUF",1,2023,188,121,67,862,292
"BUF",2,2014,258,161,97,991,422
"BUF",2,2015,267,138,129,995,468
"BUF",2,2016,275,157,118,880,699
"BUF",2,2017,243,154,89,961,410
"BUF",2,2018,235,133,102,933,411
"BUF",2,2019,226,131,95,978,512
"BUF",2,2020,267,187,80,1491,321
"BUF",2,2021,268,190,78,1454,301
"BUF",2,2022,222,159,63,1246,349
"BUF",2,2023,234,154,80,1014,340
"BUF",3,2014,226,125,101,957,455
"BUF",3,2015,210,104,106,912,475
"BUF",3,2016,204,111,93,905,510
"BUF",3,2017,199,95,104,787,421
"BUF",3,2018,236,124,112,805,408
"BUF",3,2019,190,103,87,631,380
"BUF",3,2020,238,153,85,1251,324
"BUF",3,2021,246,158,88,1103,485
"BUF",3,2022,176,110,66,831,381
"BUF",3,2023,186,113,73,953,311
"BUF",4,2014,266,179,87,1375,233
"BUF",4,2015,239,135,104,1104,556
"BUF",4,2016,250,129,121,943,502
"BUF",4,2017,219,121,98,729,319
"BUF",4,2018,256,163,93,1216,343
"BUF",4,2019,226,113,113,873,458
"BUF",4,2020,245,137,108,1280,552
"BUF",4,2021,232,141,91,1013,408
"BUF",4,2022,196,111,85,795,331
"BUF",4,2023,188,100,88,760,393
"BUF",5,2014,5,1,4,20,57
"BUF",5,2015,0,0,0,0,0
"BUF",5,2016,16,6,10,48,32
"BUF",5,2017,0,0,0,0,0
"BUF",5,2018,0,0,0,0,0
"BUF",5,2019,0,0,0,0,0
"BUF",5,2020,0,0,0,0,0
"BUF",5,2021,3,2,1,3,3
"BUF",5,2022,4,4,0,21,0
"BUF",5,2023,12,8,4,17,5
"CAR",1,2014,264,132,132,841,594
"CAR",1,2015,233,120,113,883,602
"CAR",1,2016,210,103,107,689,472
"CAR",1,2017,205,104,101,674,419
"CAR",1,2018,222,110,112,887,667
"CAR",1,2019,214,117,97,862,409
"CAR",1,2020,227,139,88,939,365
"CAR",1,2021,218,110,108,767,507
"CAR",1,2022,178,88,90,476,357
"CAR",1,2023,158,79,79,527,331
"CAR",2,2014,261,163,98,1082,333
"CAR",2,2015,279,170,109,1461,522
"CAR",2,2016,283,177,106,1386,488
"CAR",2,2017,279,161,118,1222,495
"CAR",2,2018,240,148,92,1178,455
"CAR",2,2019,229,162,67,1129,327
"CAR",2,2020,250,150,100,1201,477
"CAR",2,2021,249,153,96,1047,377
"CAR",2,2022,198,106,92,675,406
"CAR",2,2023,225,141,84,686,297
"CAR",3,2014,225,132,93,1025,471
"CAR",3,2015,254,120,134,885,600
"CAR",3,2016,271,157,114,1149,417
"CAR",3,2017,250,138,112,1044,505
"CAR",3,2018,207,126,81,751,361
"CAR",3,2019,230,138,92,1093,611
"CAR",3,2020,217,132,85,887,282
"CAR",3,2021,203,114,89,675,345
"CAR",3,2022,162,91,71,541,359
"CAR",3,2023,198,111,87,659,335
"CAR",4,2014,244,137,107,1182,422
"CAR",4,2015,234,110,124,848,405
"CAR",4,2016,277,159,118,1287,448
"CAR",4,2017,232,123,109,786,478
"CAR",4,2018,293,202,91,1503,418
"CAR",4,2019,274,185,89,1060,392
"CAR",4,2020,246,156,90,1305,376
"CAR",4,2021,254,176,78,1058,286
"CAR",4,2022,221,117,104,1125,492
"CAR",4,2023,239,171,68,934,230
"CAR",5,2014,12,7,5,38,26
"CAR",5,2015,9,8,1,60,0
"CAR",5,2016,0,0,0,0,0
"CAR",5,2017,0,0,0,0,0
"CAR",5,2018,0,0,0,0,0
"CAR",5,2019,0,0,0,0,0
"CAR",5,2020,0,0,0,0,0
"CAR",5,2021,0,0,0,0,0
"CAR",5,2022,3,0,3,0,6
"CAR",5,2023,0,0,0,0,0
"CHI",1,2014,218,137,81,841,268
"CHI",1,2015,217,107,110,856,456
"CHI",1,2016,205,116,89,766,434
"CHI",1,2017,203,89,114,655,400
"CHI",1,2018,235,120,115,990,570
"CHI",1,2019,186,107,79,619,215
"CHI",1,2020,226,127,99,874,527
"CHI",1,2021,202,100,102,748,513
"CHI",1,2022,174,79,95,624,451
"CHI",1,2023,173,89,84,813,379
"CHI",2,2014,259,186,73,1384,327
"CHI",2,2015,272,146,126,1187,538
"CHI",2,2016,251,147,104,1294,552
"CHI",2,2017,209,122,87,859,417
"CHI",2,2018,272,160,112,1166,393
"CHI",2,2019,256,175,81,1008,349
"CHI",2,2020,251,163,88,1127,328
"CHI",2,2021,214,118,96,833,393
"CHI",2,2022,190,83,107,580,511
"CHI",2,2023,196,114,82,767,342
"CHI",3,2014,225,147,78,1338,336
"CHI",3,2015,244,128,116,892,479
"CHI",3,2016,207,112,95,1001,461
"CHI",3,2017,193,96,97,752,372
"CHI",3,2018,227,146,81,1031,344
"CHI",3,2019,217,123,94,1017,372
"CHI",3,2020,210,128,82,869,299
"CHI",3,2021,190,105,85,863,275
"CHI",3,2022,168,70,98,633,555
"CHI",3,2023,195,97,98,588,442
"CHI",4,2014,267,177,90,1154,352
"CHI",4,2015,258,161,97,1285,344
"CHI",4,2016,296,219,77,1610,295
"CHI",4,2017,287,197,90,1193,310
"CHI",4,2018,227,123,104,864,312
"CHI",4,2019,252,169,83,1089,282
"CHI",4,2020,298,210,88,1211,313
"CHI",4,2021,229,162,67,1121,215
"CHI",4,2022,189,86,103,520,563
"CHI",4,2023,201,111,90,701,358
"CHI",5,2014,4,3,1,3,13
"CHI",5,2015,10,6,4,25,4
"CHI",5,2016,0,0,0,0,0
"CHI",5,2017,14,3,11,27,138
"CHI",5,2018,11,5,6,28,47
"CHI",5,2019,0,0,0,0,0
"CHI",5,2020,4,3,1,17,4
"CHI",5,2021,0,0,0,0,0
"CHI",5,2022,0,0,0,0,0
"CHI",5,2023,0,0,0,0,0
"CIN",1,2014,232,121,111,812,532
"CIN",1,2015,228,118,110,1080,446
"CIN",1,2016,227,126,101,963,492
"CIN",1,2017,224,124,100,868,458
"CIN",1,2018,213,123,90,935,320
"CIN",1,2019,189,104,85,658,384
"CIN",1,2020,235,146,89,1157,290
"CIN",1,2021,216,135,81,996,279
"CIN",1,2022,213,142,71,1103,258
"CIN",1,2023,179,124,55,803,250
"CIN",2,2014,263,142,121,1046,641
"CIN",2,2015,232,149,83,1209,348
"CIN",2,2016,284,177,107,1456,316
"CIN",2,2017,242,142,100,1206,414
"CIN",2,2018,244,166,78,1032,453
"CIN",2,2019,242,163,79,1244,259
"CIN",2,2020,261,166,95,1101,368
"CIN",2,2021,203,131,72,1348,300
"CIN",2,2022,207,143,64,1152,290
"CIN",2,2023,200,133,67,853,290
"CIN",3,2014,243,135,108,1149,357
"CIN",3,2015,233,125,108,1016,452
"CIN",3,2016,232,126,106,936,436
"CIN",3,2017,204,129,75,858,213
"CIN",3,2018,209,128,81,856,336
"CIN",3,2019,239,144,95,897,409
"CIN",3,2020,208,127,81,688,399
"CIN",3,2021,216,112,104,1174,498
"CIN",3,2022,203,126,77,882,334
"CIN",3,2023,164,109,55,948,208
"CIN",4,2014,248,131,117,988,514
"CIN",4,2015,252,142,110,1179,445
"CIN",4,2016,248,154,94,1041,379
"CIN",4,2017,215,137,78,718,246
"CIN",4,2018,251,162,89,1132,438
"CIN",4,2019,271,203,68,1399,231
"CIN",4,2020,275,159,116,1074,481
"CIN",4,2021,221,120,101,1084,428
"CIN",4,2022,222,127,95,992,359
"CIN",4,2023,188,121,67,793,202
"CIN",5,2014,17,10,7,77,25
"CIN",5,2015,10,5,5,30,26
"CIN",5,2016,13,8,5,46,16
"CIN",5,2017,3,2,1,7,-2
"CIN",5,2018,0,0,0,0,0
"CIN",5,2019,6,3,3,10,8
"CIN",5,2020,10,8,2,28,15
"CIN",5,2021,24,8,16,126,48
"CIN",5,2022,12,8,4,52,8
"CIN",5,2023,11,5,6,36,6
"CLE",1,2014,210,113,97,786,294
"CLE",1,2015,214,132,82,873,303
"CLE",1,2016,196,120,76,860,350
"CLE",1,2017,194,97,97,622,344
"CLE",1,2018,222,126,96,971,401
"CLE",1,2019,235,143,92,1102,399
"CLE",1,2020,233,134,99,1044,466
"CLE",1,2021,210,122,88,1016,448
"CLE",1,2022,179,92,87,835,451
"CLE",1,2023,203,115,88,879,435
"CLE",2,2014,273,143,130,1108,540
"CLE",2,2015,266,181,85,1355,246
"CLE",2,2016,224,158,66,1005,270
"CLE",2,2017,254,177,77,1360,352
"CLE",2,2018,261,161,100,1296,458
"CLE",2,2019,256,169,87,1213,426
"CLE",2,2020,274,167,107,1250,445
"CLE",2,2021,255,156,99,1109,509
"CLE",2,2022,230,130,100,903,433
"CLE",2,2023,229,146,83,825,340
"CLE",3,2014,247,123,124,933,501
"CLE",3,2015,209,139,70,962,256
"CLE",3,2016,193,120,73,781,354
"CLE",3,2017,204,118,86,811,440
"CLE",3,2018,223,127,96,1021,427
"CLE",3,2019,196,105,91,762,470
"CLE",3,2020,223,119,104,867,457
"CLE",3,2021,162,79,83,632,484
"CLE",3,2022,178,97,81,571,350
"CLE",3,2023,206,114,92,674,310
"CLE",4,2014,261,156,105,1209,345
"CLE",4,2015,242,188,54,1276,267
"CLE",4,2016,233,185,48,1230,293
"CLE",4,2017,263,221,42,1281,150
"CLE",4,2018,248,168,80,1306,463
"CLE",4,2019,234,141,93,1084,434
"CLE",4,2020,254,101,153,733,900
"CLE",4,2021,253,120,133,713,704
"CLE",4,2022,243,135,108,911,551
"CLE",4,2023,236,127,109,805,445
"CLE",5,2014,0,0,0,0,0
"CLE",5,2015,12,4,8,32,16
"CLE",5,2016,22,15,7,43,35
"CLE",5,2017,8,5,3,7,3
"CLE",5,2018,30,20,10,116,21
"CLE",5,2019,0,0,0,0,0
"CLE",5,2020,0,0,0,0,0
"CLE",5,2021,0,0,0,0,0
"CLE",5,2022,9,3,6,63,10
"CLE",5,2023,0,0,0,0,0
"DAL",1,2014,258,127,131,1091,613
"DAL",1,2015,242,122,120,802,649
"DAL",1,2016,242,124,118,1069,675
"DAL",1,2017,257,132,125,872,498
"DAL",1,2018,238,130,108,963,480
"DAL",1,2019,232,132,100,897,498
"DAL",1,2020,208,114,94,876,331
"DAL",1,2021,288,159,129,1261,623
"DAL",1,2022,215,102,113,764,531
"DAL",1,2023,192,120,72,920,364
"DAL",2,2014,283,158,125,1256,653
"DAL",2,2015,239,153,86,1241,301
"DAL",2,2016,261,156,105,1128,499
"DAL",2,2017,247,155,92,1007,410
"DAL",2,2018,248,150,98,1061,464
"DAL",2,2019,284,170,114,1461,587
"DAL",2,2020,285,185,100,1366,358
"DAL",2,2021,283,192,91,1387,348
"DAL",2,2022,250,145,105,1051,599
"DAL",2,2023,243,165,78,1268,326
"DAL",3,2014,214,99,115,980,646
"DAL",3,2015,205,97,108,799,571
"DAL",3,2016,201,98,103,806,513
"DAL",3,2017,198,98,100,636,560
"DAL",3,2018,204,112,92,786,439
"DAL",3,2019,212,122,90,1260,398
"DAL",3,2020,238,135,103,1076,423
"DAL",3,2021,207,122,85,955,512
"DAL",3,2022,193,94,99,815,428
"DAL",3,2023,184,105,79,708,361
"DAL",4,2014,226,113,113,914,453
"DAL",4,2015,266,190,76,1451,319
"DAL",4,2016,257,122,135,891,615
"DAL",4,2017,278,147,131,1365,572
"DAL",4,2018,260,163,97,1167,409
"DAL",4,2019,264,174,90,1342,418
"DAL",4,2020,328,225,103,1492,521
"DAL",4,2021,227,147,80,1187,348
"DAL",4,2022,224,116,108,763,462
"DAL",4,2023,219,111,108,856,447
"DAL",5,2014,12,6,6,40,26
"DAL",5,2015,0,0,0,0,0
"DAL",5,2016,12,5,7,56,19
"DAL",5,2017,0,0,0,0,0
"DAL",5,2018,20,8,12,87,31
"DAL",5,2019,0,0,0,0,0
"DAL",5,2020,0,0,0,0,0
"DAL",5,2021,10,8,2,77,9
"DAL",5,2022,14,7,7,92,66
"DAL",5,2023,0,0,0,0,0
"DEN",1,2014,262,146,116,1247,438
"DEN",1,2015,235,138,97,1102,365
"DEN",1,2016,218,138,80,843,283
"DEN",1,2017,267,141,126,1116,486
"DEN",1,2018,221,122,99,764,441
"DEN",1,2019,205,117,88,946,356
"DEN",1,2020,214,110,104,672,418
"DEN",1,2021,206,99,107,618,495
"DEN",1,2022,185,106,79,684,316
"DEN",1,2023,162,78,84,558,439
"DEN",2,2014,291,193,98,1670,376
"DEN",2,2015,266,177,89,1262,406
"DEN",2,2016,274,171,103,1124,543
"DEN",2,2017,262,166,96,1101,395
"DEN",2,2018,277,188,89,1273,544
"DEN",2,2019,239,138,101,986,388
"DEN",2,2020,275,174,101,1202,505
"DEN",2,2021,233,150,83,1050,353
"DEN",2,2022,223,140,83,1124,390
"DEN",2,2023,198,128,70,834,294
"DEN",3,2014,261,152,109,1214,708
"DEN",3,2015,235,141,94,983,336
"DEN",3,2016,213,127,86,784,354
"DEN",3,2017,222,114,108,908,493
"DEN",3,2018,215,125,90,992,506
"DEN",3,2019,209,116,93,735,385
"DEN",3,2020,216,122,94,774,382
"DEN",3,2021,198,105,93,751,476
"DEN",3,2022,194,106,88,646,337
"DEN",3,2023,147,73,74,528,300
"DEN",4,2014,264,156,108,1225,389
"DEN",4,2015,270,161,109,1183,479
"DEN",4,2016,271,164,107,1420,301
"DEN",4,2017,265,176,89,1202,322
"DEN",4,2018,293,194,99,1556,477
"DEN",4,2019,224,140,84,760,454
"DEN",4,2020,273,179,94,1381,472
"DEN",4,2021,263,158,105,1255,409
"DEN",4,2022,224,146,78,891,303
"DEN",4,2023,201,121,80,828,256
"DEN",5,2014,0,0,0,0,0
"DEN",5,2015,32,19,13,93,92
"DEN",5,2016,16,8,8,43,23
"DEN",5,2017,0,0,0,0,0
"DEN",5,2018,0,0,0,0,0
"DEN",5,2019,0,0,0,0,0
"DEN",5,2020,0,0,0,0,0
"DEN",5,2021,0,0,0,0,0
"DEN",5,2022,12,5,7,61,21
"DEN",5,2023,0,0,0,0,0
"DET",1,2014,237,146,91,1178,287
"DET",1,2015,202,119,83,921,348
"DET",1,2016,223,131,92,819,406
"DET",1,2017,207,123,84,910,313
"DET",1,2018,231,121,110,900,451
"DET",1,2019,219,118,101,1110,346
"DET",1,2020,215,113,102,863,489
"DET",1,2021,192,96,96,631,407
"DET",1,2022,207,113,94,860,454
"DET",1,2023,178,93,85,747,510
"DET",2,2014,269,189,80,1189,288
"DET",2,2015,265,184,81,1349,295
"DET",2,2016,282,197,85,1536,321
"DET",2,2017,279,193,86,1431,357
"DET",2,2018,278,169,109,1027,443
"DET",2,2019,231,142,89,925,392
"DET",2,2020,259,163,96,1329,322
"DET",2,2021,260,150,110,971,479
"DET",2,2022,247,145,102,1090,425
"DET",2,2023,244,156,88,1192,385
"DET",3,2014,241,146,95,1108,332
"DET",3,2015,207,130,77,988,272
"DET",3,2016,205,125,80,841,221
"DET",3,2017,234,139,95,1244,255
"DET",3,2018,216,127,89,1012,370
"DET",3,2019,218,119,99,1013,494
"DET",3,2020,222,131,91,1027,367
"DET",3,2021,181,101,80,655,428
"DET",3,2022,190,108,82,827,369
"DET",3,2023,195,108,87,820,427
"DET",4,2014,259,157,102,1040,478
"DET",4,2015,295,214,81,1484,262
"DET",4,2016,237,171,66,1299,217
"DET",4,2017,241,158,83,1295,238
"DET",4,2018,279,193,86,1235,372
"DET",4,2019,253,186,67,1241,255
"DET",4,2020,264,203,61,1509,229
"DET",4,2021,273,193,80,1220,277
"DET",4,2022,239,141,98,1009,366
"DET",4,2023,223,126,97,945,476
"DET",5,2014,0,0,0,0,0
"DET",5,2015,16,11,5,99,11
"DET",5,2016,11,7,4,73,6
"DET",5,2017,0,0,0,0,0
"DET",5,2018,0,0,0,0,0
"DET",5,2019,11,8,3,63,16
"DET",5,2020,0,0,0,0,0
"DET",5,2021,13,8,5,53,10
"DET",5,2022,0,0,0,0,0
"DET",5,2023,0,0,0,0,0
"GB",1,2014,266,151,115,1432,647
"GB",1,2015,258,150,108,851,523
"GB",1,2016,235,151,84,1127,317
"GB",1,2017,218,120,98,845,412
"GB",1,2018,204,121,83,955,484
"GB",1,2019,193,121,72,1127,287
"GB",1,2020,240,136,104,1036,521
"GB",1,2021,189,111,78,813,293
"GB",1,2022,181,98,83,649,316
"GB",1,2023,160,87,73,562,253
"GB",2,2014,257,177,80,1382,292
"GB",2,2015,259,176,83,1091,232
"GB",2,2016,260,196,64,1348,404
"GB",2,2017,203,133,70,865,301
"GB",2,2018,251,173,78,1155,284
"GB",2,2019,268,176,92,967,461
"GB",2,2020,270,173,97,1517,382
"GB",2,2021,267,183,84,1396,388
"GB",2,2022,194,112,82,807,463
"GB",2,2023,199,124,75,722,412
"GB",3,2014,223,124,99,981,385
"GB",3,2015,235,136,99,901,424
"GB",3,2016,245,157,88,1035,407
"GB",3,2017,221,134,87,799,359
"GB",3,2018,242,174,68,1227,332
"GB",3,2019,212,132,80,880,373
"GB",3,2020,222,131,91,1026,557
"GB",3,2021,220,129,91,1020,461
"GB",3,2022,171,86,85,594,480
"GB",3,2023,185,112,73,1069,234
"GB",4,2014,222,115,107,893,474
"GB",4,2015,271,174,97,1214,350
"GB",4,2016,237,152,85,1170,252
"GB",4,2017,280,207,73,1263,262
"GB",4,2018,253,193,60,1561,237
"GB",4,2019,220,125,95,930,396
"GB",4,2020,222,112,110,890,576
"GB",4,2021,213,115,98,870,393
"GB",4,2022,220,160,60,1039,325
"GB",4,2023,223,144,79,972,360
"GB",5,2014,0,0,0,0,0
"GB",5,2015,0,0,0,0,0
"GB",5,2016,0,0,0,0,0
"GB",5,2017,17,9,8,123,54
"GB",5,2018,14,9,5,31,29
"GB",5,2019,0,0,0,0,0
"GB",5,2020,2,2,0,8,0
"GB",5,2021,6,3,3,35,-6
"GB",5,2022,18,7,11,86,44
"GB",5,2023,0,0,0,0,0
"HOU",1,2014,244,120,124,822,568
"HOU",1,2015,262,145,117,790,405
"HOU",1,2016,223,115,108,643,434
"HOU",1,2017,231,121,110,905,381
"HOU",1,2018,217,114,103,1052,475
"HOU",1,2019,211,121,90,753,344
"HOU",1,2020,197,123,74,918,267
"HOU",1,2021,207,106,101,757,374
"HOU",1,2022,193,106,87,640,283
"HOU",1,2023,198,109,89,908,323
"HOU",2,2014,250,142,108,1038,397
"HOU",2,2015,289,186,103,1247,413
"HOU",2,2016,289,176,113,958,434
"HOU",2,2017,260,153,107,1073,513
"HOU",2,2018,224,131,93,921,471
"HOU",2,2019,225,143,82,1086,411
"HOU",2,2020,246,176,70,1651,263
"HOU",2,2021,224,136,88,1060,243
"HOU",2,2022,186,109,77,539,477
"HOU",2,2023,224,141,83,1134,334
"HOU",3,2014,267,130,137,1006,610
"HOU",3,2015,260,151,109,1173,461
"HOU",3,2016,234,145,89,926,355
"HOU",3,2017,253,141,112,879,397
"HOU",3,2018,237,129,108,1084,407
"HOU",3,2019,180,106,74,1098,350
"HOU",3,2020,189,113,76,1016,379
"HOU",3,2021,198,102,96,537,298
"HOU",3,2022,189,109,80,863,256
"HOU",3,2023,169,98,71,830,231
"HOU",4,2014,246,123,123,939,362
"HOU",4,2015,276,167,109,1201,395
"HOU",4,2016,299,178,121,1112,582
"HOU",4,2017,247,152,95,1335,350
"HOU",4,2018,249,152,97,1164,319
"HOU",4,2019,221,124,97,998,538
"HOU",4,2020,212,154,58,1461,234
"HOU",4,2021,234,164,70,1032,223
"HOU",4,2022,221,159,62,1212,196
"HOU",4,2023,200,121,79,1079,268
"HOU",5,2014,4,1,3,0,32
"HOU",5,2015,0,0,0,0,0
"HOU",5,2016,5,2,3,45,7
"HOU",5,2017,0,0,0,0,0
"HOU",5,2018,18,11,7,142,14
"HOU",5,2019,0,0,0,0,0
"HOU",5,2020,0,0,0,0,0
"HOU",5,2021,0,0,0,0,0
"HOU",5,2022,6,5,1,26,-2
"HOU",5,2023,0,0,0,0,0
"IND",1,2014,273,173,100,1197,366
"IND",1,2015,244,143,101,1013,431
"IND",1,2016,230,134,96,907,367
"IND",1,2017,185,96,89,720,282
"IND",1,2018,241,143,98,1061,326
"IND",1,2019,177,97,80,655,295
"IND",1,2020,243,122,121,1053,630
"IND",1,2021,199,103,96,809,601
"IND",1,2022,174,91,83,599,311
"IND",1,2023,174,92,82,620,498
"IND",2,2014,272,198,74,1662,353
"IND",2,2015,235,151,84,914,357
"IND",2,2016,264,176,88,1422,406
"IND",2,2017,231,144,87,1013,338
"IND",2,2018,308,208,100,1458,477
"IND",2,2019,278,167,111,1207,476
"IND",2,2020,282,189,93,1696,312
"IND",2,2021,257,153,104,921,472
"IND",2,2022,219,150,69,1043,279
"IND",2,2023,250,162,88,997,302
"IND",3,2014,253,167,86,1473,356
"IND",3,2015,227,145,82,1027,219
"IND",3,2016,221,127,94,1001,291
"IND",3,2017,194,106,88,837,305
"IND",3,2018,212,130,82,1028,427
"IND",3,2019,224,117,107,757,563
"IND",3,2020,230,115,115,698,583
"IND",3,2021,211,115,96,741,624
"IND",3,2022,182,101,81,705,348
"IND",3,2023,175,97,78,698,356
"IND",4,2014,261,162,99,1153,298
"IND",4,2015,279,203,76,1498,188
"IND",4,2016,252,183,69,1605,240
"IND",4,2017,202,129,73,715,211
"IND",4,2018,279,185,94,1353,405
"IND",4,2019,252,139,113,844,554
"IND",4,2020,273,156,117,1023,560
"IND",4,2021,241,116,125,859,578
"IND",4,2022,213,150,63,1022,237
"IND",4,2023,200,126,74,813,226
"IND",5,2014,0,0,0,0,0
"IND",5,2015,12,7,5,40,29
"IND",5,2016,4,3,1,14,7
"IND",5,2017,14,9,5,118,35
"IND",5,2018,17,13,4,75,14
"IND",5,2019,0,0,0,0,0
"IND",5,2020,3,0,3,0,8
"IND",5,2021,7,5,2,22,8
"IND",5,2022,17,11,6,94,14
"IND",5,2023,17,8,9,115,23
"JAX",1,2014,213,107,106,739,520
"JAX",1,2015,220,126,94,971,348
"JAX",1,2016,233,120,113,761,499
"JAX",1,2017,247,127,120,1025,623
"JAX",1,2018,187,89,98,590,331
"JAX",1,2019,168,93,75,794,338
"JAX",1,2020,211,116,95,765,428
"JAX",1,2021,169,93,76,573,389
"JAX",1,2022,188,99,89,698,445
"JAX",1,2023,185,108,77,718,238
"JAX",2,2014,243,161,82,1058,269
"JAX",2,2015,255,173,82,1258,332
"JAX",2,2016,253,171,82,1169,368
"JAX",2,2017,310,183,127,1249,379
"JAX",2,2018,246,142,104,903,536
"JAX",2,2019,237,156,81,965,290
"JAX",2,2020,249,173,76,1185,333
"JAX",2,2021,254,156,98,958,418
"JAX",2,2022,231,156,75,1116,410
"JAX",2,2023,216,135,81,1077,299
"JAX",3,2014,206,131,75,676,315
"JAX",3,2015,221,130,91,1069,387
"JAX",3,2016,262,158,104,1051,367
"JAX",3,2017,230,110,120,919,521
"JAX",3,2018,235,149,86,1093,291
"JAX",3,2019,210,123,87,795,398
"JAX",3,2020,201,122,79,967,363
"JAX",3,2021,207,130,77,819,414
"JAX",3,2022,228,127,101,976,464
"JAX",3,2023,196,128,68,963,231
"JAX",4,2014,266,187,79,1466,345
"JAX",4,2015,248,198,50,1565,208
"JAX",4,2016,281,218,63,1417,165
"JAX",4,2017,244,123,121,784,566
"JAX",4,2018,249,175,74,1107,247
"JAX",4,2019,288,212,76,1456,349
"JAX",4,2020,271,219,52,1395,275
"JAX",4,2021,267,194,73,1106,245
"JAX",4,2022,219,138,81,891,317
"JAX",4,2023,206,119,87,739,293
"JAX",5,2014,0,0,0,0,0
"JAX",5,2015,13,6,7,14,51
"JAX",5,2016,0,0,0,0,0
"JAX",5,2017,23,11,12,17,19
"JAX",5,2018,0,0,0,0,0
"JAX",5,2019,0,0,0,0,0
"JAX",5,2020,3,2,1,0,2
"JAX",5,2021,0,0,0,0,0
"JAX",5,2022,3,2,1,11,1
"JAX",5,2023,8,6,2,60,9
"KC",1,2014,222,115,107,829,516
"KC",1,2015,189,103,86,787,400
"KC",1,2016,215,119,96,981,586
"KC",1,2017,193,121,72,951,290
"KC",1,2018,213,153,60,1286,414
"KC",1,2019,226,162,64,1316,265
"KC",1,2020,237,165,72,1561,382
"KC",1,2021,230,149,81,1124,349
"KC",1,2022,197,139,58,1093,316
"KC",1,2023,165,104,61,789,333
"KC",2,2014,223,131,92,913,447
"KC",2,2015,247,156,91,1217,416
"KC",2,2016,233,155,78,1129,324
"KC",2,2017,248,163,85,1280,365
"KC",2,2018,241,168,73,1509,377
"KC",2,2019,272,199,73,1747,240
"KC",2,2020,267,197,70,1288,427
"KC",2,2021,243,173,70,1073,346
"KC",2,2022,255,183,72,1344,378
"KC",2,2023,229,163,66,1371,257
"KC",3,2014,221,126,95,978,353
"KC",3,2015,217,123,94,892,353
"KC",3,2016,216,133,83,1045,346
"KC",3,2017,229,131,98,1091,449
"KC",3,2018,228,151,77,1528,320
"KC",3,2019,219,143,76,1085,325
"KC",3,2020,237,144,93,1265,452
"KC",3,2021,268,177,91,1336,393
"KC",3,2022,212,140,72,1225,330
"KC",3,2023,197,126,71,908,311
"KC",4,2014,239,149,90,975,388
"KC",4,2015,220,119,101,911,478
"KC",4,2016,256,148,108,1017,351
"KC",4,2017,258,149,109,1154,555
"KC",4,2018,252,141,111,1067,389
"KC",4,2019,211,103,108,742,431
"KC",4,2020,256,150,106,1335,280
"KC",4,2021,217,134,83,1049,313
"KC",4,2022,209,112,97,979,395
"KC",4,2023,191,124,67,753,228
"KC",5,2014,0,0,0,0,0
"KC",5,2015,0,0,0,0,0
"KC",5,2016,20,11,9,95,38
"KC",5,2017,6,3,3,16,11
"KC",5,2018,9,8,1,68,3
"KC",5,2019,0,0,0,0,0
"KC",5,2020,11,7,4,21,11
"KC",5,2021,5,5,0,75,0
"KC",5,2022,20,15,5,113,34
"KC",5,2023,0,0,0,0,0
"LA",1,2014,218,114,104,955,481
"LA",1,2015,204,102,102,779,294
"LA",1,2016,225,130,95,930,409
"LA",1,2017,218,137,81,858,416
"LA",1,2018,232,139,93,1154,394
"LA",1,2019,186,115,71,829,286
"LA",1,2020,248,148,100,1153,372
"LA",1,2021,202,129,73,954,351
"LA",1,2022,172,96,76,706,289
"LA",1,2023,175,105,70,759,300
"LA",2,2014,216,117,99,950,419
"LA",2,2015,236,141,95,738,459
"LA",2,2016,226,140,86,1015,264
"LA",2,2017,259,167,92,1368,451
"LA",2,2018,285,185,100,1420,588
"LA",2,2019,260,178,82,1423,316
"LA",2,2020,293,183,110,1145,546
"LA",2,2021,267,176,91,1349,372
"LA",2,2022,188,116,72,754,258
"LA",2,2023,220,131,89,1064,359
"LA",3,2014,216,117,99,721,488
"LA",3,2015,211,111,100,793,533
"LA",3,2016,216,123,93,818,324
"LA",3,2017,229,124,105,1118,528
"LA",3,2018,238,136,102,1355,590
"LA",3,2019,216,127,89,999,385
"LA",3,2020,270,157,113,1249,589
"LA",3,2021,212,134,78,1302,397
"LA",3,2022,157,91,66,672,324
"LA",3,2023,191,102,89,793,468
"LA",4,2014,278,201,77,1606,251
"LA",4,2015,239,136,103,823,585
"LA",4,2016,256,173,83,1029,227
"LA",4,2017,267,115,152,804,587
"LA",4,2018,263,140,123,1054,599
"LA",4,2019,251,163,88,1180,366
"LA",4,2020,237,120,117,858,493
"LA",4,2021,235,128,107,966,417
"LA",4,2022,211,145,66,1067,199
"LA",4,2023,221,137,84,776,351
"LA",5,2014,0,0,0,0,0
"LA",5,2015,19,8,11,59,16
"LA",5,2016,0,0,0,0,0
"LA",5,2017,0,0,0,0,0
"LA",5,2018,0,0,0,0,0
"LA",5,2019,0,0,0,0,0
"LA",5,2020,0,0,0,0,0
"LA",5,2021,0,0,0,0,0
"LA",5,2022,0,0,0,0,0
"LA",5,2023,11,7,4,60,21
"LAC",1,2014,214,111,103,848,342
"LAC",1,2015,218,124,94,985,282
"LAC",1,2016,240,136,104,1252,382
"LAC",1,2017,217,118,99,826,429
"LAC",1,2018,196,112,84,1057,401
"LAC",1,2019,208,119,89,1027,353
"LAC",1,2020,249,144,105,1004,465
"LAC",1,2021,201,124,77,848,329
"LAC",1,2022,181,114,67,811,266
"LAC",1,2023,176,98,78,670,346
"LAC",2,2014,270,176,94,1409,360
"LAC",2,2015,307,211,96,1460,323
"LAC",2,2016,259,164,95,1296,378
"LAC",2,2017,301,203,98,1658,432
"LAC",2,2018,224,145,79,1244,406
"LAC",2,2019,276,183,93,1503,393
"LAC",2,2020,300,193,107,1551,347
"LAC",2,2021,263,179,84,1463,416
"LAC",2,2022,273,190,83,1394,325
"LAC",2,2023,218,156,62,1002,272
"LAC",3,2014,247,159,88,1325,266
"LAC",3,2015,252,160,92,1183,343
"LAC",3,2016,232,140,92,1090,393
"LAC",3,2017,222,139,83,1294,347
"LAC",3,2018,221,116,105,1086,578
"LAC",3,2019,180,101,79,963,359
"LAC",3,2020,250,147,103,1138,427
"LAC",3,2021,209,136,73,916,338
"LAC",3,2022,193,131,62,853,229
"LAC",3,2023,186,119,67,843,256
"LAC",4,2014,257,165,92,1185,310
"LAC",4,2015,322,218,104,1793,389
"LAC",4,2016,271,169,102,1211,374
"LAC",4,2017,272,154,118,1131,425
"LAC",4,2018,225,121,104,952,556
"LAC",4,2019,253,184,69,1334,245
"LAC",4,2020,273,164,109,1106,444
"LAC",4,2021,271,175,96,1562,377
"LAC",4,2022,257,183,74,1216,232
"LAC",4,2023,206,133,73,994,164
"LAC",5,2014,8,2,6,18,22
"LAC",5,2015,4,3,1,2,5
"LAC",5,2016,4,1,3,11,5
"LAC",5,2017,3,3,0,52,0
"LAC",5,2018,0,0,0,0,0
"LAC",5,2019,8,3,5,41,34
"LAC",5,2020,15,9,6,65,7
"LAC",5,2021,0,0,0,0,0
"LAC",5,2022,10,7,3,20,1
"LAC",5,2023,3,3,0,0,0
"LV",1,2014,208,127,81,732,269
"LV",1,2015,213,122,91,831,403
"LV",1,2016,233,140,93,927,340
"LV",1,2017,202,108,94,728,400
"LV",1,2018,216,121,95,1063,367
"LV",1,2019,229,120,109,1019,573
"LV",1,2020,194,109,85,1058,342
"LV",1,2021,204,128,76,956,300
"LV",1,2022,212,119,93,868,368
"LV",1,2023,179,103,76,843,283
"LV",2,2014,251,162,89,965,371
"LV",2,2015,248,154,94,1304,436
"LV",2,2016,278,176,102,1131,617
"LV",2,2017,258,156,102,1350,377
"LV",2,2018,274,173,101,1243,441
"LV",2,2019,244,152,92,1288,347
"LV",2,2020,268,172,96,1416,460
"LV",2,2021,243,161,82,1074,282
"LV",2,2022,225,129,96,1024,476
"LV",2,2023,186,103,83,691,338
"LV",3,2014,240,162,78,997,360
"LV",3,2015,247,145,102,1074,433
"LV",3,2016,240,146,94,909,457
"LV",3,2017,205,115,90,632,386
"LV",3,2018,218,122,96,1031,482
"LV",3,2019,185,94,91,698,407
"LV",3,2020,254,142,112,1126,447
"LV",3,2021,221,130,91,1160,427
"LV",3,2022,170,89,81,620,501
"LV",3,2023,164,99,65,647,264
"LV",4,2014,273,200,73,1224,260
"LV",4,2015,258,199,59,1352,171
"LV",4,2016,274,159,115,1263,467
"LV",4,2017,292,218,74,1405,366
"LV",4,2018,231,154,77,1110,297
"LV",4,2019,234,129,105,949,414
"LV",4,2020,275,152,123,1161,508
"LV",4,2021,226,153,73,1304,254
"LV",4,2022,234,163,71,1081,306
"LV",4,2023,200,133,67,840,196
"LV",5,2014,0,0,0,0,0
"LV",5,2015,14,11,3,95,7
"LV",5,2016,21,17,4,219,24
"LV",5,2017,0,0,0,0,0
"LV",5,2018,15,8,7,103,15
"LV",5,2019,0,0,0,0,0
"LV",5,2020,13,4,9,17,55
"LV",5,2021,31,15,16,192,80
"LV",5,2022,16,10,6,101,108
"LV",5,2023,0,0,0,0,0
"MIA",1,2014,207,118,89,890,405
"MIA",1,2015,212,113,99,775,479
"MIA",1,2016,184,94,90,601,390
"MIA",1,2017,214,121,93,735,474
"MIA",1,2018,206,106,100,626,457
"MIA",1,2019,208,130,78,1041,170
"MIA",1,2020,221,126,95,859,368
"MIA",1,2021,219,138,81,903,271
"MIA",1,2022,166,110,56,908,239
"MIA",1,2023,157,93,64,989,307
"MIA",2,2014,272,180,92,1359,439
"MIA",2,2015,252,170,82,1317,423
"MIA",2,2016,244,140,104,1036,491
"MIA",2,2017,241,141,100,960,336
"MIA",2,2018,237,153,84,1185,433
"MIA",2,2019,238,164,74,1096,194
"MIA",2,2020,237,162,75,1175,275
"MIA",2,2021,260,186,74,1198,242
"MIA",2,2022,224,154,70,1188,293
"MIA",2,2023,239,161,78,1426,470
"MIA",3,2014,244,150,94,1026,634
"MIA",3,2015,215,128,87,1050,365
"MIA",3,2016,225,125,100,1319,401
"MIA",3,2017,231,151,80,1069,368
"MIA",3,2018,190,103,87,677,470
"MIA",3,2019,172,117,55,559,143
"MIA",3,2020,239,141,98,968,353
"MIA",3,2021,185,112,73,743,291
"MIA",3,2022,168,95,73,837,324
"MIA",3,2023,213,114,99,1065,513
"MIA",4,2014,293,183,110,1145,430
"MIA",4,2015,280,207,73,1394,237
"MIA",4,2016,218,130,88,972,406
"MIA",4,2017,292,215,77,1591,261
"MIA",4,2018,185,116,69,1011,263
"MIA",4,2019,263,187,76,1353,312
"MIA",4,2020,271,156,115,1100,495
"MIA",4,2021,244,143,101,1081,344
"MIA",4,2022,185,123,62,1096,260
"MIA",4,2023,178,84,94,617,648
"MIA",5,2014,0,0,0,0,0
"MIA",5,2015,0,0,0,0,0
"MIA",5,2016,17,5,12,50,114
"MIA",5,2017,0,0,0,0,0
"MIA",5,2018,13,5,8,57,56
"MIA",5,2019,12,10,2,75,2
"MIA",5,2020,0,0,0,0,0
"MIA",5,2021,11,10,1,54,15
"MIA",5,2022,0,0,0,0,0
"MIA",5,2023,0,0,0,0,0
"MIN",1,2014,195,99,96,827,422
"MIN",1,2015,251,124,127,845,527
"MIN",1,2016,227,134,93,1044,303
"MIN",1,2017,234,130,104,884,335
"MIN",1,2018,216,120,96,827,430
"MIN",1,2019,214,115,99,852,415
"MIN",1,2020,212,101,111,826,567
"MIN",1,2021,203,114,89,1004,475
"MIN",1,2022,195,118,77,855,290
"MIN",1,2023,141,79,62,652,285
"MIN",2,2014,265,174,91,1214,369
"MIN",2,2015,256,150,106,1011,387
"MIN",2,2016,223,145,78,1012,201
"MIN",2,2017,303,187,116,1475,462
"MIN",2,2018,264,190,74,1396,370
"MIN",2,2019,241,139,102,1186,487
"MIN",2,2020,242,140,102,1197,397
"MIN",2,2021,261,158,103,1061,400
"MIN",2,2022,236,165,71,1105,338
"MIN",2,2023,247,171,76,1520,252
"MIN",3,2014,199,105,94,700,462
"MIN",3,2015,186,84,102,621,499
"MIN",3,2016,243,151,92,1013,359
"MIN",3,2017,259,140,119,1139,616
"MIN",3,2018,218,138,80,957,365
"MIN",3,2019,229,122,107,963,483
"MIN",3,2020,262,150,112,1372,560
"MIN",3,2021,217,120,97,846,488
"MIN",3,2022,152,98,54,595,281
"MIN",3,2023,179,111,68,767,319
"MIN",4,2014,245,160,85,1158,308
"MIN",4,2015,227,119,108,864,634
"MIN",4,2016,282,186,96,1268,267
"MIN",4,2017,247,114,133,802,497
"MIN",4,2018,256,173,83,1348,319
"MIN",4,2019,225,96,129,862,639
"MIN",4,2020,268,146,122,1161,707
"MIN",4,2021,272,162,110,1300,379
"MIN",4,2022,223,144,79,1079,248
"MIN",4,2023,228,155,73,895,200
"MIN",5,2014,3,2,1,90,2
"MIN",5,2015,6,1,5,6,23
"MIN",5,2016,0,0,0,0,0
"MIN",5,2017,0,0,0,0,0
"MIN",5,2018,13,9,4,85,17
"MIN",5,2019,0,0,0,0,0
"MIN",5,2020,14,6,8,78,31
"MIN",5,2021,21,14,7,79,23
"MIN",5,2022,10,5,5,37,26
"MIN",5,2023,0,0,0,0,0
"NE",1,2014,226,127,99,820,422
"NE",1,2015,227,146,81,1250,311
"NE",1,2016,270,153,117,1260,562
"NE",1,2017,269,161,108,1242,450
"NE",1,2018,255,144,111,1051,454
"NE",1,2019,230,134,96,1041,348
"NE",1,2020,183,78,105,484,506
"NE",1,2021,191,88,103,657,558
"NE",1,2022,176,92,84,753,362
"NE",1,2023,172,93,79,667,305
"NE",2,2014,303,207,96,1428,377
"NE",2,2015,285,182,103,1214,455
"NE",2,2016,277,165,112,1246,444
"NE",2,2017,296,188,108,1385,561
"NE",2,2018,294,185,109,1291,609
"NE",2,2019,284,199,85,1039,284
"NE",2,2020,264,133,131,1024,618
"NE",2,2021,258,168,90,1299,387
"NE",2,2022,198,127,71,908,314
"NE",2,2023,189,122,67,1076,256
"NE",3,2014,277,174,103,1309,469
"NE",3,2015,267,167,100,1525,368
"NE",3,2016,241,144,97,1172,376
"NE",3,2017,263,149,114,1327,426
"NE",3,2018,258,148,110,1076,517
"NE",3,2019,226,138,88,1153,425
"NE",3,2020,216,108,108,923,605
"NE",3,2021,213,112,101,910,560
"NE",3,2022,197,112,85,939,432
"NE",3,2023,173,87,86,524,341
"NE",4,2014,268,149,119,1086,465
"NE",4,2015,262,175,87,1591,281
"NE",4,2016,253,126,127,1013,490
"NE",4,2017,250,139,111,967,476
"NE",4,2018,261,122,139,1195,574
"NE",4,2019,225,121,104,852,372
"NE",4,2020,266,143,123,1102,485
"NE",4,2021,237,127,110,1037,428
"NE",4,2022,209,121,88,816,412
"NE",4,2023,232,148,84,900,371
"NE",5,2014,0,0,0,0,0
"NE",5,2015,2,2,0,0,0
"NE",5,2016,0,0,0,0,0
"NE",5,2017,0,0,0,0,0
"NE",5,2018,0,0,0,0,0
"NE",5,2019,0,0,0,0,0
"NE",5,2020,0,0,0,0,0
"NE",5,2021,5,3,2,14,7
"NE",5,2022,3,1,2,0,5
"NE",5,2023,0,0,0,0,0
"NO",1,2014,230,147,83,1114,356
"NO",1,2015,259,164,95,1330,341
"NO",1,2016,259,140,119,1070,418
"NO",1,2017,226,131,95,1026,492
"NO",1,2018,233,131,102,1101,455
"NO",1,2019,228,144,84,1085,352
"NO",1,2020,213,106,107,696,637
"NO",1,2021,211,111,100,725,379
"NO",1,2022,159,80,79,588,379
"NO",1,2023,216,125,91,868,376
"NO",2,2014,273,187,86,1428,428
"NO",2,2015,266,175,91,1248,391
"NO",2,2016,307,205,102,1524,493
"NO",2,2017,251,150,101,1204,516
"NO",2,2018,262,174,88,1384,410
"NO",2,2019,240,169,71,1277,276
"NO",2,2020,286,182,104,1339,518
"NO",2,2021,219,124,95,886,387
"NO",2,2022,192,122,70,895,382
"NO",2,2023,179,113,66,769,244
"NO",3,2014,252,150,102,1312,398
"NO",3,2015,235,148,87,1136,358
"NO",3,2016,221,138,83,1279,353
"NO",3,2017,232,131,101,1046,506
"NO",3,2018,208,111,97,913,412
"NO",3,2019,232,129,103,1059,620
"NO",3,2020,230,118,112,1048,490
"NO",3,2021,193,100,93,634,403
"NO",3,2022,183,94,89,794,341
"NO",3,2023,203,111,92,788,362
"NO",4,2014,295,187,108,1373,578
"NO",4,2015,333,221,112,1769,395
"NO",4,2016,307,213,94,1810,520
"NO",4,2017,272,146,126,1275,572
"NO",4,2018,262,120,142,892,722
"NO",4,2019,220,131,89,954,383
"NO",4,2020,244,121,123,1006,440
"NO",4,2021,240,136,104,1129,353
"NO",4,2022,217,151,66,1306,272
"NO",4,2023,236,144,92,1013,397
"NO",5,2014,24,15,9,86,45
"NO",5,2015,2,2,0,80,0
"NO",5,2016,0,0,0,0,0
"NO",5,2017,2,0,2,0,51
"NO",5,2018,15,11,4,73,8
"NO",5,2019,0,0,0,0,0
"NO",5,2020,21,15,6,90,51
"NO",5,2021,0,0,0,0,0
"NO",5,2022,0,0,0,0,0
"NO",5,2023,0,0,0,0,0
"NYG",1,2014,252,139,113,1257,315
"NYG",1,2015,240,141,99,1036,386
"NYG",1,2016,214,127,87,731,333
"NYG",1,2017,245,136,109,794,476
"NYG",1,2018,207,119,88,1011,363
"NYG",1,2019,156,88,68,516,449
"NYG",1,2020,189,110,79,822,356
"NYG",1,2021,203,114,89,746,390
"NYG",1,2022,145,88,57,569,173
"NYG",1,2023,165,79,86,511,304
"NYG",2,2014,288,184,104,1232,426
"NYG",2,2015,294,195,99,1376,389
"NYG",2,2016,303,201,102,1537,365
"NYG",2,2017,253,157,96,981,371
"NYG",2,2018,263,173,90,1255,537
"NYG",2,2019,258,175,83,1292,344
"NYG",2,2020,219,132,87,924,375
"NYG",2,2021,200,127,73,815,326
"NYG",2,2022,200,110,90,815,404
"NYG",2,2023,179,116,63,804,160
"NYG",3,2014,248,135,113,1141,498
"NYG",3,2015,250,148,102,1107,443
"NYG",3,2016,223,132,91,904,356
"NYG",3,2017,235,143,92,851,333
"NYG",3,2018,207,116,91,975,463
"NYG",3,2019,231,145,86,1240,281
"NYG",3,2020,195,124,71,817,334
"NYG",3,2021,214,134,80,877,285
"NYG",3,2022,184,87,97,737,493
"NYG",3,2023,139,64,75,572,351
"NYG",4,2014,289,180,109,1273,359
"NYG",4,2015,266,176,90,1395,345
"NYG",4,2016,277,171,106,1213,422
"NYG",4,2017,286,200,86,1253,358
"NYG",4,2018,278,195,83,1448,298
"NYG",4,2019,231,180,51,1046,235
"NYG",4,2020,240,181,59,1098,245
"NYG",4,2021,272,201,71,1106,255
"NYG",4,2022,209,111,98,720,420
"NYG",4,2023,200,122,78,771,345
"NYG",5,2014,0,0,0,0,0
"NYG",5,2015,7,6,1,29,4
"NYG",5,2016,0,0,0,0,0
"NYG",5,2017,8,5,3,60,15
"NYG",5,2018,7,3,4,13,36
"NYG",5,2019,11,5,6,35,31
"NYG",5,2020,0,0,0,0,0
"NYG",5,2021,9,6,3,73,14
"NYG",5,2022,11,9,2,64,2
"NYG",5,2023,4,4,0,1,0
"NYJ",1,2014,239,106,133,876,573
"NYJ",1,2015,255,142,113,1043,368
"NYJ",1,2016,224,124,100,894,343
"NYJ",1,2017,194,94,100,748,394
"NYJ",1,2018,213,108,105,765,342
"NYJ",1,2019,222,124,98,945,356
"NYJ",1,2020,241,133,108,875,376
"NYJ",1,2021,172,104,68,556,300
"NYJ",1,2022,171,101,70,626,272
"NYJ",1,2023,155,91,64,522,204
"NYJ",2,2014,252,130,122,780,528
"NYJ",2,2015,252,165,87,1120,417
"NYJ",2,2016,249,151,98,1061,545
"NYJ",2,2017,252,154,98,1171,359
"NYJ",2,2018,226,142,84,1191,318
"NYJ",2,2019,229,142,87,1125,316
"NYJ",2,2020,246,143,103,937,474
"NYJ",2,2021,240,137,103,932,392
"NYJ",2,2022,232,144,88,1119,343
"NYJ",2,2023,189,117,72,705,394
"NYJ",3,2014,209,114,95,956,367
"NYJ",3,2015,227,133,94,1012,462
"NYJ",3,2016,228,140,88,887,400
"NYJ",3,2017,235,123,112,762,544
"NYJ",3,2018,223,119,104,791,602
"NYJ",3,2019,189,110,79,747,289
"NYJ",3,2020,184,105,79,836,295
"NYJ",3,2021,196,119,77,931,303
"NYJ",3,2022,201,116,85,792,368
"NYJ",3,2023,156,94,62,707,288
"NYJ",4,2014,262,160,102,971,472
"NYJ",4,2015,283,175,108,1059,383
"NYJ",4,2016,263,164,99,1084,356
"NYJ",4,2017,247,156,91,1137,296
"NYJ",4,2018,262,171,91,1079,298
"NYJ",4,2019,223,145,78,955,221
"NYJ",4,2020,224,143,81,653,339
"NYJ",4,2021,273,209,64,1460,321
"NYJ",4,2022,261,170,91,1203,487
"NYJ",4,2023,211,164,47,1044,119
"NYJ",5,2014,5,2,3,26,7
"NYJ",5,2015,17,11,6,127,19
"NYJ",5,2016,6,1,5,26,42
"NYJ",5,2017,11,6,5,47,10
"NYJ",5,2018,0,0,0,0,0
"NYJ",5,2019,0,0,0,0,0
"NYJ",5,2020,0,0,0,0,0
"NYJ",5,2021,12,7,5,58,14
"NYJ",5,2022,0,0,0,0,0
"NYJ",5,2023,6,4,2,11,5
"PHI",1,2014,231,144,87,1086,411
"PHI",1,2015,251,142,109,1021,477
"PHI",1,2016,228,128,100,843,386
"PHI",1,2017,241,133,108,1006,477
"PHI",1,2018,192,112,80,803,358
"PHI",1,2019,225,122,103,720,420
"PHI",1,2020,219,114,105,778,510
"PHI",1,2021,209,119,90,839,431
"PHI",1,2022,222,141,81,1121,315
"PHI",1,2023,193,115,78,767,322
"PHI",2,2014,316,211,105,1746,447
"PHI",2,2015,295,195,100,1169,388
"PHI",2,2016,268,178,90,1102,352
"PHI",2,2017,284,177,107,1098,471
"PHI",2,2018,286,190,96,1554,381
"PHI",2,2019,272,183,89,1010,365
"PHI",2,2020,265,169,96,1056,517
"PHI",2,2021,238,131,107,1044,540
"PHI",2,2022,253,153,100,1514,522
"PHI",2,2023,190,113,77,798,275
"PHI",3,2014,273,155,118,1058,568
"PHI",3,2015,239,144,95,1071,426
"PHI",3,2016,249,139,110,1005,522
"PHI",3,2017,248,150,98,1112,475
"PHI",3,2018,264,163,101,1381,435
"PHI",3,2019,227,130,97,977,479
"PHI",3,2020,210,130,80,911,469
"PHI",3,2021,214,96,118,772,606
"PHI",3,2022,180,98,82,698,512
"PHI",3,2023,198,108,90,943,443
"PHI",4,2014,276,146,130,1122,438
"PHI",4,2015,288,174,114,1383,418
"PHI",4,2016,310,196,114,1162,478
"PHI",4,2017,248,133,115,882,486
"PHI",4,2018,256,158,98,1156,398
"PHI",4,2019,271,169,102,1251,466
"PHI",4,2020,266,209,57,1116,190
"PHI",4,2021,221,111,110,809,535
"PHI",4,2022,219,63,156,550,648
"PHI",4,2023,200,106,94,893,320
"PHI",5,2014,0,0,0,0,0
"PHI",5,2015,9,5,4,56,34
"PHI",5,2016,0,0,0,0,0
"PHI",5,2017,0,0,0,0,0
"PHI",5,2018,8,3,5,14,42
"PHI",5,2019,8,4,4,34,41
"PHI",5,2020,13,9,4,47,8
"PHI",5,2021,0,0,0,0,0
"PHI",5,2022,0,0,0,0,0
"PHI",5,2023,17,11,6,61,41
"PIT",1,2014,260,134,126,914,552
"PIT",1,2015,262,160,102,1281,414
"PIT",1,2016,228,135,93,1191,422
"PIT",1,2017,241,136,105,1064,462
"PIT",1,2018,243,157,86,1172,378
"PIT",1,2019,172,105,67,595,279
"PIT",1,2020,243,148,95,687,303
"PIT",1,2021,199,117,82,746,272
"PIT",1,2022,201,110,91,653,356
"PIT",1,2023,148,79,69,528,249
"PIT",2,2014,278,200,78,1696,338
"PIT",2,2015,269,182,87,1514,374
"PIT",2,2016,271,182,89,1248,393
"PIT",2,2017,285,193,92,1512,327
"PIT",2,2018,304,237,67,1748,283
"PIT",2,2019,225,157,68,1080,241
"PIT",2,2020,289,200,89,1623,357
"PIT",2,2021,223,137,86,833,392
"PIT",2,2022,237,131,106,979,422
"PIT",2,2023,199,123,76,651,347
"PIT",3,2014,209,127,82,1026,365
"PIT",3,2015,195,122,73,1030,376
"PIT",3,2016,231,125,106,875,564
"PIT",3,2017,235,137,98,945,418
"PIT",3,2018,235,145,90,1366,431
"PIT",3,2019,201,129,72,1005,317
"PIT",3,2020,253,177,76,1043,320
"PIT",3,2021,230,149,81,866,350
"PIT",3,2022,202,123,79,740,318
"PIT",3,2023,188,107,81,681,433
"PIT",4,2014,286,173,113,1548,550
"PIT",4,2015,254,162,92,1584,449
"PIT",4,2016,285,177,108,1331,440
"PIT",4,2017,274,158,116,1362,463
"PIT",4,2018,255,176,79,1191,310
"PIT",4,2019,204,135,69,794,192
"PIT",4,2020,264,174,90,1127,401
"PIT",4,2021,284,196,88,1350,304
"PIT",4,2022,212,130,82,904,316
"PIT",4,2023,204,122,82,946,370
"PIT",5,2014,0,0,0,0,0
"PIT",5,2015,10,5,5,18,33
"PIT",5,2016,9,8,1,76,-1
"PIT",5,2017,0,0,0,0,0
"PIT",5,2018,15,11,4,73,5
"PIT",5,2019,2,1,1,10,3
"PIT",5,2020,0,0,0,0,0
"PIT",5,2021,18,14,4,95,7
"PIT",5,2022,14,12,2,81,14
"PIT",5,2023,0,0,0,0,0
"SEA",1,2014,194,93,101,621,504
"SEA",1,2015,205,96,109,614,470
"SEA",1,2016,190,111,79,794,336
"SEA",1,2017,223,129,94,778,258
"SEA",1,2018,230,89,141,654,784
"SEA",1,2019,185,92,93,902,422
"SEA",1,2020,227,139,88,1230,456
"SEA",1,2021,162,79,83,676,377
"SEA",1,2022,173,104,69,799,319
"SEA",1,2023,184,105,79,843,385
"SEA",2,2014,265,149,116,1511,623
"SEA",2,2015,256,154,102,1342,407
"SEA",2,2016,270,182,88,1690,356
"SEA",2,2017,238,164,74,1216,270
"SEA",2,2018,251,132,119,1035,490
"SEA",2,2019,255,148,107,1218,492
"SEA",2,2020,246,169,77,1289,358
"SEA",2,2021,200,137,63,1264,267
"SEA",2,2022,231,160,71,1342,234
"SEA",2,2023,212,144,68,968,298
"SEA",3,2014,232,117,115,818,630
"SEA",3,2015,223,115,108,1077,648
"SEA",3,2016,212,121,91,688,444
"SEA",3,2017,247,159,88,1067,393
"SEA",3,2018,214,97,117,735,642
"SEA",3,2019,193,104,89,761,415
"SEA",3,2020,195,113,82,828,438
"SEA",3,2021,203,102,101,598,456
"SEA",3,2022,186,120,66,934,310
"SEA",3,2023,165,94,71,787,248
"SEA",4,2014,237,108,129,797,622
"SEA",4,2015,239,131,108,1125,493
"SEA",4,2016,273,177,96,1466,299
"SEA",4,2017,227,144,83,1324,289
"SEA",4,2018,256,129,127,1203,468
"SEA",4,2019,258,146,112,1080,465
"SEA",4,2020,253,158,95,1204,319
"SEA",4,2021,208,143,65,881,304
"SEA",4,2022,197,121,76,1023,468
"SEA",4,2023,176,122,54,720,271
"SEA",5,2014,10,6,4,35,24
"SEA",5,2015,15,9,6,62,10
"SEA",5,2016,15,8,7,104,23
"SEA",5,2017,0,0,0,0,0
"SEA",5,2018,4,2,2,40,6
"SEA",5,2019,26,20,6,194,20
"SEA",5,2020,11,10,1,117,-6
"SEA",5,2021,6,4,2,31,-3
"SEA",5,2022,3,2,1,5,0
"SEA",5,2023,9,7,2,69,6
"SF",1,2014,208,113,95,902,492
"SF",1,2015,212,109,103,634,420
"SF",1,2016,214,102,112,865,476
"SF",1,2017,226,122,104,936,442
"SF",1,2018,209,112,97,856,541
"SF",1,2019,192,108,84,859,429
"SF",1,2020,249,115,134,967,688
"SF",1,2021,209,105,104,929,437
"SF",1,2022,203,102,101,804,545
"SF",1,2023,191,102,89,739,520
"SF",2,2014,251,153,98,1302,420
"SF",2,2015,244,151,93,1064,404
"SF",2,2016,249,128,121,1010,506
"SF",2,2017,280,183,97,1391,450
"SF",2,2018,275,170,105,1287,394
"SF",2,2019,229,137,92,1116,675
"SF",2,2020,273,155,118,1084,559
"SF",2,2021,240,136,104,1005,490
"SF",2,2022,232,149,83,1209,386
"SF",2,2023,206,117,89,1028,398
"SF",3,2014,217,122,95,773,392
"SF",3,2015,177,100,77,875,186
"SF",3,2016,194,98,96,444,392
"SF",3,2017,230,127,103,960,413
"SF",3,2018,223,120,103,1270,574
"SF",3,2019,227,106,121,1198,499
"SF",3,2020,210,111,99,1003,446
"SF",3,2021,205,107,98,1082,467
"SF",3,2022,197,95,102,751,552
"SF",3,2023,156,85,71,1150,409
"SF",4,2014,250,137,113,829,411
"SF",4,2015,242,174,68,1193,228
"SF",4,2016,255,181,74,1042,244
"SF",4,2017,253,175,78,1135,317
"SF",4,2018,247,160,87,1300,303
"SF",4,2019,220,97,123,664,488
"SF",4,2020,298,212,86,1641,345
"SF",4,2021,221,122,99,992,394
"SF",4,2022,225,112,113,858,476
"SF",4,2023,188,80,108,800,419
"SF",5,2014,7,2,5,5,47
"SF",5,2015,13,12,1,157,1
"SF",5,2016,6,3,3,13,25
"SF",5,2017,26,16,10,44,29
"SF",5,2018,7,1,6,0,29
"SF",5,2019,8,5,3,7,9
"SF",5,2020,0,0,0,0,0
"SF",5,2021,7,6,1,77,2
"SF",5,2022,0,0,0,0,0
"SF",5,2023,0,0,0,0,0
"TB",1,2014,203,114,89,704,395
"TB",1,2015,211,93,118,823,592
"TB",1,2016,248,120,128,938,514
"TB",1,2017,234,132,102,992,349
"TB",1,2018,243,143,100,1313,434
"TB",1,2019,214,123,91,1143,292
"TB",1,2020,226,142,84,1083,284
"TB",1,2021,244,167,77,1199,450
"TB",1,2022,212,121,91,904,377
"TB",1,2023,184,110,74,701,241
"TB",2,2014,234,147,87,1068,353
"TB",2,2015,255,161,94,1149,467
"TB",2,2016,278,181,97,1237,318
"TB",2,2017,258,180,78,1264,291
"TB",2,2018,267,191,76,1697,254
"TB",2,2019,259,185,74,1635,271
"TB",2,2020,293,209,84,1444,349
"TB",2,2021,283,198,85,1602,319
"TB",2,2022,237,165,72,1120,222
"TB",2,2023,206,125,81,832,329
"TB",3,2014,212,110,102,895,332
"TB",3,2015,249,131,118,1151,580
"TB",3,2016,252,146,106,1353,375
"TB",3,2017,231,136,95,1228,434
"TB",3,2018,227,141,86,1292,368
"TB",3,2019,206,123,83,1002,380
"TB",3,2020,238,162,76,1432,426
"TB",3,2021,227,146,81,1043,383
"TB",3,2022,220,152,68,851,297
"TB",3,2023,148,83,65,648,201
"TB",4,2014,244,188,56,1402,202
"TB",4,2015,273,185,88,1371,461
"TB",4,2016,257,173,84,1094,296
"TB",4,2017,254,188,66,1558,180
"TB",4,2018,239,178,61,1558,184
"TB",4,2019,235,153,82,1335,242
"TB",4,2020,250,150,100,1138,493
"TB",4,2021,234,155,79,1082,328
"TB",4,2022,267,203,64,1217,195
"TB",4,2023,232,152,80,991,319
"TB",5,2014,1,1,0,10,0
"TB",5,2015,16,10,6,31,26
"TB",5,2016,6,4,2,5,7
"TB",5,2017,0,0,0,0,0
"TB",5,2018,10,8,2,55,-4
"TB",5,2019,0,0,0,0,0
"TB",5,2020,0,0,0,0,0
"TB",5,2021,7,5,2,71,4
"TB",5,2022,13,11,2,47,6
"TB",5,2023,0,0,0,0,0
"TEN",1,2014,191,96,95,660,347
"TEN",1,2015,208,109,99,769,379
"TEN",1,2016,224,106,118,783,550
"TEN",1,2017,217,106,111,840,389
"TEN",1,2018,214,113,101,952,313
"TEN",1,2019,190,106,84,953,401
"TEN",1,2020,203,110,93,1042,348
"TEN",1,2021,214,117,97,898,323
"TEN",1,2022,177,92,85,721,394
"TEN",1,2023,175,92,83,547,307
"TEN",2,2014,228,159,69,1190,275
"TEN",2,2015,256,164,92,1219,362
"TEN",2,2016,275,163,112,1257,622
"TEN",2,2017,249,154,95,957,443
"TEN",2,2018,208,109,99,721,477
"TEN",2,2019,196,114,82,988,359
"TEN",2,2020,265,133,132,1010,791
"TEN",2,2021,250,138,112,1112,558
"TEN",2,2022,233,137,96,907,572
"TEN",2,2023,181,107,74,840,328
"TEN",3,2014,209,109,100,841,464
"TEN",3,2015,207,113,94,911,431
"TEN",3,2016,211,95,116,831,551
"TEN",3,2017,218,118,100,1052,412
"TEN",3,2018,165,81,84,702,416
"TEN",3,2019,202,95,107,1019,675
"TEN",3,2020,243,117,126,991,664
"TEN",3,2021,220,113,107,696,482
"TEN",3,2022,150,70,80,686,351
"TEN",3,2023,157,90,67,616,304
"TEN",4,2014,229,169,60,1318,202
"TEN",4,2015,257,188,69,1358,188
"TEN",4,2016,273,172,101,1206,340
"TEN",4,2017,246,140,106,901,525
"TEN",4,2018,222,116,106,922,491
"TEN",4,2019,231,135,96,1161,415
"TEN",4,2020,277,144,133,917,780
"TEN",4,2021,252,127,125,892,553
"TEN",4,2022,185,88,97,604,345
"TEN",4,2023,188,121,67,935,266
"TEN",5,2014,0,0,0,0,0
"TEN",5,2015,9,6,3,62,18
"TEN",5,2016,0,0,0,0,0
"TEN",5,2017,11,5,6,38,15
"TEN",5,2018,15,13,2,48,4
"TEN",5,2019,0,0,0,0,0
"TEN",5,2020,11,5,6,91,59
"TEN",5,2021,29,18,11,77,36
"TEN",5,2022,2,1,1,0,1
"TEN",5,2023,18,7,11,32,46
"WAS",1,2014,215,118,97,891,411
"WAS",1,2015,242,130,112,1188,460
"WAS",1,2016,229,146,83,1138,311
"WAS",1,2017,215,115,100,929,336
"WAS",1,2018,198,106,92,640,362
"WAS",1,2019,184,94,90,688,425
"WAS",1,2020,226,122,104,663,473
"WAS",1,2021,201,106,95,773,371
"WAS",1,2022,148,69,79,493,282
"WAS",1,2023,177,116,61,877,222
"WAS",2,2014,256,157,99,1262,484
"WAS",2,2015,263,155,108,1271,430
"WAS",2,2016,252,162,90,1252,434
"WAS",2,2017,247,155,92,1110,383
"WAS",2,2018,227,151,76,1185,340
"WAS",2,2019,214,124,90,880,478
"WAS",2,2020,259,183,76,1126,302
"WAS",2,2021,232,144,88,979,312
"WAS",2,2022,232,137,95,814,470
"WAS",2,2023,219,157,62,951,267
"WAS",3,2014,244,139,105,1438,423
"WAS",3,2015,215,127,88,950,307
"WAS",3,2016,239,147,92,1414,306
"WAS",3,2017,220,137,83,1146,291
"WAS",3,2018,221,125,96,867,334
"WAS",3,2019,183,102,81,792,319
"WAS",3,2020,212,133,79,1045,346
"WAS",3,2021,214,115,99,748,475
"WAS",3,2022,201,95,106,793,428
"WAS",3,2023,166,99,67,759,326
"WAS",4,2014,232,161,71,1231,270
"WAS",4,2015,282,171,111,1141,424
"WAS",4,2016,262,170,92,1416,587
"WAS",4,2017,246,148,98,1139,371
"WAS",4,2018,205,126,79,854,392
"WAS",4,2019,205,144,61,965,261
"WAS",4,2020,299,187,112,1206,425
"WAS",4,2021,260,163,97,1108,424
"WAS",4,2022,245,160,85,1078,301
"WAS",4,2023,225,159,66,1156,270
"WAS",5,2014,8,5,3,49,9
"WAS",5,2015,7,5,2,86,3
"WAS",5,2016,22,14,8,91,36
"WAS",5,2017,2,2,0,0,0
"WAS",5,2018,0,0,0,0,0
"WAS",5,2019,0,0,0,0,0
"WAS",5,2020,0,0,0,0,0
"WAS",5,2021,0,0,0,0,0
"WAS",5,2022,7,1,6,1,36
"WAS",5,2023,3,2,1,5,0
